1111111111111
1C010000000C1
1000011111001
1P0011E000001
1000011000001
1C00111000001
1010000111C01
1111111111111